%%%%%%%
%    <%
% %%% %
%  %  %
%%   %%
%. %%%%
%%%%%%%
